"sourcemonth","srcm_month","open_year","segment","hori","horitext","newbuild","rmsincns","rmsfnlpl","rmsplnnn","rmstotal","rmsuncnf","htlsincns","htlsfnlpl","htlsplnnn","htlstotal","htlsuncnf"
2007-05-01,"May",2007-01-01,"luxus",0,"Current year",1320,1187,0,0,1187,0,5,0,0,5,1
2007-05-01,"May",2007-01-01,"upuus",0,"Current year",6928,6713,0,250,6963,0,31,0,1,32,0
2007-05-01,"May",2007-01-01,"upsus",0,"Current year",22825,21018,624,1439,23081,0,185,6,13,204,0
2007-05-01,"May",2007-01-01,"midwus",0,"Current year",5321,7112,591,877,8580,0,89,6,8,103,0
2007-05-01,"May",2007-01-01,"midwous",0,"Current year",39347,34557,4836,3644,43037,0,421,56,44,521,0
2007-05-01,"May",2007-01-01,"ecous",0,"Current year",8866,7227,802,717,8746,0,81,11,12,104,0
2007-05-01,"May",2007-01-01,"indus",0,"Current year",9328,18282,2234,3224,23740,0,155,22,36,213,0
2007-05-01,"May",2007-01-01,"ustot",0,"Current year",93935,96096,9087,10151,115334,0,967,101,114,1182,1
2008-05-01,"May",2008-01-01,"luxus",0,"Current year",5163,2870,0,0,2870,0,11,0,0,11,0
2008-05-01,"May",2008-01-01,"upuus",0,"Current year",13195,9647,0,0,9647,0,35,0,0,35,0
2008-05-01,"May",2008-01-01,"upsus",0,"Current year",29721,29445,5615,0,35060,0,241,45,0,286,0
2008-05-01,"May",2008-01-01,"midwus",0,"Current year",8983,6289,824,0,7113,0,66,7,0,73,0
2008-05-01,"May",2008-01-01,"midwous",0,"Current year",52697,42421,9575,0,51996,0,503,125,0,628,0
2008-05-01,"May",2008-01-01,"ecous",0,"Current year",11391,9992,5016,0,15008,0,103,66,0,169,0
2008-05-01,"May",2008-01-01,"indus",0,"Current year",18571,21623,3242,0,24865,0,126,31,0,157,0
2008-05-01,"May",2008-01-01,"ustot",0,"Current year",139721,122287,24272,0,146559,0,1085,274,0,1359,0
2009-05-01,"May",2009-01-01,"luxus",0,"Current year",4046,3957,0,0,3957,0,16,0,0,16,0
2009-05-01,"May",2009-01-01,"upuus",0,"Current year",11039,7092,0,0,7092,0,24,0,0,24,0
2009-05-01,"May",2009-01-01,"upsus",0,"Current year",41006,28150,0,0,28150,0,225,0,0,225,0
2009-05-01,"May",2009-01-01,"midwus",0,"Current year",8272,6371,0,0,6371,0,65,0,0,65,0
2009-05-01,"May",2009-01-01,"midwous",0,"Current year",59842,41227,0,0,41227,0,486,0,0,486,0
2009-05-01,"May",2009-01-01,"ecous",0,"Current year",9607,5225,0,0,5225,0,58,0,0,58,0
2009-05-01,"May",2009-01-01,"indus",0,"Current year",14629,15891,0,0,15891,0,76,0,0,76,0
2009-05-01,"May",2009-01-01,"ustot",0,"Current year",148441,107913,0,0,107913,0,950,0,0,950,0
2010-05-01,"May",2010-01-01,"luxus",0,"Current year",3894,1712,0,0,1712,0,7,0,0,7,0
2010-05-01,"May",2010-01-01,"upuus",0,"Current year",7188,3001,0,0,3001,0,8,0,0,8,0
2010-05-01,"May",2010-01-01,"upsus",0,"Current year",19135,11296,0,0,11296,0,88,0,0,88,0
2010-05-01,"May",2010-01-01,"midwus",0,"Current year",4851,3751,0,0,3751,0,40,0,0,40,0
2010-05-01,"May",2010-01-01,"midwous",0,"Current year",30660,22095,0,0,22095,0,273,0,0,273,0
2010-05-01,"May",2010-01-01,"ecous",0,"Current year",4086,1658,0,0,1658,0,21,0,0,21,0
2010-05-01,"May",2010-01-01,"indus",0,"Current year",11688,7003,0,0,7003,0,58,0,0,58,0
2010-05-01,"May",2010-01-01,"ustot",0,"Current year",81502,50516,0,0,50516,0,495,0,0,495,0
2011-05-01,"May",2011-01-01,"luxus",0,"Current year",1807,0,0,0,0,0,0,0,0,0,0
2011-05-01,"May",2011-01-01,"upuus",0,"Current year",6002,4268,0,0,4268,0,13,0,0,13,0
2011-05-01,"May",2011-01-01,"upsus",0,"Current year",8955,6049,0,0,6049,0,48,0,0,48,0
2011-05-01,"May",2011-01-01,"upmus",0,"Current year",15363,8644,0,0,8644,0,91,0,0,91,0
2011-05-01,"May",2011-01-01,"midus",0,"Current year",4601,3597,0,0,3597,0,51,0,0,51,0
2011-05-01,"May",2011-01-01,"ecous",0,"Current year",1745,732,0,0,732,0,12,0,0,12,0
2011-05-01,"May",2011-01-01,"indus",0,"Current year",3634,3015,0,0,3015,0,42,0,0,42,0
2011-05-01,"May",2011-01-01,"ustot",0,"Current year",42107,26305,0,0,26305,0,257,0,0,257,0
2012-05-01,"May",2012-01-01,"luxus",0,"Current year",208,209,0,0,209,0,2,0,0,2,0
2012-05-01,"May",2012-01-01,"upuus",0,"Current year",2548,2194,0,0,2194,0,9,0,0,9,0
2012-05-01,"May",2012-01-01,"upsus",0,"Current year",10050,8299,0,0,8299,0,63,0,0,63,0
2012-05-01,"May",2012-01-01,"upmus",0,"Current year",16401,11037,0,0,11037,0,118,0,0,118,0
2012-05-01,"May",2012-01-01,"midus",0,"Current year",3571,2578,0,0,2578,0,33,0,0,33,0
2012-05-01,"May",2012-01-01,"ecous",0,"Current year",2731,1051,0,0,1051,0,13,0,0,13,0
2012-05-01,"May",2012-01-01,"indus",0,"Current year",7084,4789,0,0,4789,0,41,0,0,41,0
2012-05-01,"May",2012-01-01,"ustot",0,"Current year",42593,30157,0,0,30157,0,279,0,0,279,0
2013-05-01,"May",2013-01-01,"luxus",0,"Current year",693,799,0,0,799,0,4,0,0,4,0
2013-05-01,"May",2013-01-01,"upuus",0,"Current year",4458,2782,0,0,2782,0,13,0,0,13,0
2013-05-01,"May",2013-01-01,"upsus",0,"Current year",18571,15610,0,0,15610,0,117,0,0,117,0
2013-05-01,"May",2013-01-01,"upmus",0,"Current year",22259,13864,0,0,13864,0,152,0,0,152,0
2013-05-01,"May",2013-01-01,"midus",0,"Current year",5320,2965,0,0,2965,0,44,0,0,44,0
2013-05-01,"May",2013-01-01,"ecous",0,"Current year",3298,1291,0,0,1291,0,17,0,0,17,0
2013-05-01,"May",2013-01-01,"indus",0,"Current year",7011,4884,0,0,4884,0,42,0,0,42,0
2013-05-01,"May",2013-01-01,"ustot",0,"Current year",61610,42195,0,0,42195,0,389,0,0,389,0
2014-05-01,"May",2014-01-01,"luxus",0,"Current year",1032,2142,0,0,2142,0,4,0,0,4,0
2014-05-01,"May",2014-01-01,"upuus",0,"Current year",4592,3169,0,0,3169,0,16,0,0,16,0
2014-05-01,"May",2014-01-01,"upsus",0,"Current year",24270,17465,0,0,17465,0,140,0,0,140,0
2014-05-01,"May",2014-01-01,"upmus",0,"Current year",25855,20820,0,0,20820,0,216,0,0,216,0
2014-05-01,"May",2014-01-01,"midus",0,"Current year",5522,3445,0,0,3445,0,50,0,0,50,0
2014-05-01,"May",2014-01-01,"ecous",0,"Current year",4326,819,0,0,819,0,13,0,0,13,0
2014-05-01,"May",2014-01-01,"indus",0,"Current year",9546,6489,0,0,6489,0,57,0,0,57,0
2014-05-01,"May",2014-01-01,"ustot",0,"Current year",75143,54349,0,0,54349,0,496,0,0,496,0
2015-05-01,"May",2015-01-01,"luxus",0,"Current year",2152,704,0,0,704,0,4,0,0,4,0
2015-05-01,"May",2015-01-01,"upuus",0,"Current year",7367,5679,0,0,5679,0,23,0,0,23,0
2015-05-01,"May",2015-01-01,"upsus",0,"Current year",31263,26943,0,0,26943,0,206,0,0,206,0
2015-05-01,"May",2015-01-01,"upmus",0,"Current year",31965,25087,0,0,25087,0,266,0,0,266,0
2015-05-01,"May",2015-01-01,"midus",0,"Current year",7679,3611,0,0,3611,0,51,0,0,51,0
2015-05-01,"May",2015-01-01,"ecous",0,"Current year",4290,552,0,0,552,0,7,0,0,7,0
2015-05-01,"May",2015-01-01,"indus",0,"Current year",10572,9533,0,0,9533,0,73,0,0,73,0
2015-05-01,"May",2015-01-01,"ustot",0,"Current year",95288,72109,0,0,72109,0,630,0,0,630,0
2016-05-01,"May",2016-01-01,"luxus",0,"Current year",NA,3526,0,0,3526,0,15,0,0,15,0
2016-05-01,"May",2016-01-01,"upuus",0,"Current year",NA,4832,0,0,4832,0,22,0,0,22,0
2016-05-01,"May",2016-01-01,"upsus",0,"Current year",NA,24706,0,0,24706,0,183,0,0,183,0
2016-05-01,"May",2016-01-01,"upmus",0,"Current year",NA,20701,0,0,20701,0,213,0,0,213,0
2016-05-01,"May",2016-01-01,"midus",0,"Current year",NA,5221,0,0,5221,0,68,0,0,68,0
2016-05-01,"May",2016-01-01,"ecous",0,"Current year",NA,1005,0,0,1005,0,12,0,0,12,0
2016-05-01,"May",2016-01-01,"indus",0,"Current year",NA,10399,0,0,10399,0,78,0,0,78,0
2016-05-01,"May",2016-01-01,"ustot",0,"Current year",NA,70390,0,0,70390,0,591,0,0,591,0
2007-05-01,"May",2008-01-01,"luxus",1,"Yr1 (Next year)",5163,4547,200,0,4747,400,19,2,1,22,1
2007-05-01,"May",2008-01-01,"upuus",1,"Yr1 (Next year)",13195,17270,1116,4713,23099,1418,48,6,23,77,4
2007-05-01,"May",2008-01-01,"upsus",1,"Yr1 (Next year)",29721,17422,8814,32941,59177,3886,139,76,263,478,33
2007-05-01,"May",2008-01-01,"midwus",1,"Yr1 (Next year)",8983,2944,2712,7787,13443,422,26,22,67,115,4
2007-05-01,"May",2008-01-01,"midwous",1,"Yr1 (Next year)",52697,16541,12159,43973,72673,3330,182,150,525,857,39
2007-05-01,"May",2008-01-01,"ecous",1,"Yr1 (Next year)",11391,1811,178,1118,3107,330,18,3,12,33,5
2007-05-01,"May",2008-01-01,"indus",1,"Yr1 (Next year)",18571,14419,3445,8062,25926,3041,82,23,66,171,13
2007-05-01,"May",2008-01-01,"ustot",1,"Yr1 (Next year)",139721,74954,28624,98594,202172,12827,514,282,957,1753,99
2007-12-01,"Dec",2008-01-01,"luxus",1,"Yr1 (Next year)",5163,4234,0,0,4234,0,16,0,0,16,0
2007-12-01,"Dec",2008-01-01,"upuus",1,"Yr1 (Next year)",13195,20201,1130,1722,23053,0,66,4,8,78,0
2007-12-01,"Dec",2008-01-01,"upsus",1,"Yr1 (Next year)",29721,39606,15520,7330,62456,0,319,127,60,506,0
2007-12-01,"Dec",2008-01-01,"midwus",1,"Yr1 (Next year)",8983,10203,1414,3049,14666,0,105,14,27,146,0
2007-12-01,"Dec",2008-01-01,"midwous",1,"Yr1 (Next year)",52697,50671,19632,16587,86890,0,587,233,211,1031,0
2007-12-01,"Dec",2008-01-01,"ecous",1,"Yr1 (Next year)",11391,10952,4896,1444,17292,0,115,68,18,201,0
2007-12-01,"Dec",2008-01-01,"indus",1,"Yr1 (Next year)",18571,30930,2933,7068,40931,0,179,25,65,269,0
2007-12-01,"Dec",2008-01-01,"ustot",1,"Yr1 (Next year)",139721,166797,45525,37200,249522,0,1387,471,389,2247,0
2008-05-01,"May",2009-01-01,"luxus",1,"Yr1 (Next year)",4046,3080,120,1497,4697,0,15,1,6,22,0
2008-05-01,"May",2009-01-01,"upuus",1,"Yr1 (Next year)",11039,9681,3523,5602,18806,0,30,17,24,71,0
2008-05-01,"May",2009-01-01,"upsus",1,"Yr1 (Next year)",41006,21272,23328,40118,84718,449,156,188,325,669,4
2008-05-01,"May",2009-01-01,"midwus",1,"Yr1 (Next year)",8272,2968,4412,10673,18053,0,23,39,91,153,1
2008-05-01,"May",2009-01-01,"midwous",1,"Yr1 (Next year)",59842,16097,27545,54115,97757,193,183,321,639,1143,2
2008-05-01,"May",2009-01-01,"ecous",1,"Yr1 (Next year)",9607,1137,1705,5055,7897,0,10,24,63,97,0
2008-05-01,"May",2009-01-01,"indus",1,"Yr1 (Next year)",14629,10136,4103,18314,32553,462,67,24,89,180,3
2008-05-01,"May",2009-01-01,"ustot",1,"Yr1 (Next year)",148441,64371,64736,135374,264481,1104,484,614,1237,2335,10
2008-12-01,"Dec",2009-01-01,"luxus",1,"Yr1 (Next year)",4046,5749,430,0,6179,0,24,2,1,27,0
2008-12-01,"Dec",2009-01-01,"upuus",1,"Yr1 (Next year)",11039,11821,880,500,13201,0,42,3,2,47,0
2008-12-01,"Dec",2009-01-01,"upsus",1,"Yr1 (Next year)",41006,44499,14857,4743,64099,0,351,123,39,513,0
2008-12-01,"Dec",2009-01-01,"midwus",1,"Yr1 (Next year)",8272,7873,4214,615,12702,0,76,39,7,122,0
2008-12-01,"Dec",2009-01-01,"midwous",1,"Yr1 (Next year)",59842,56603,25712,4887,87202,0,654,309,62,1025,0
2008-12-01,"Dec",2009-01-01,"ecous",1,"Yr1 (Next year)",9607,10241,2711,1013,13965,0,114,33,12,159,0
2008-12-01,"Dec",2009-01-01,"indus",1,"Yr1 (Next year)",14629,18470,7168,2256,27894,0,119,49,21,189,0
2008-12-01,"Dec",2009-01-01,"ustot",1,"Yr1 (Next year)",148441,155256,55972,14014,225242,0,1380,558,144,2082,0
2009-05-01,"May",2010-01-01,"luxus",1,"Yr1 (Next year)",3894,1783,353,459,2595,0,6,1,2,9,0
2009-05-01,"May",2010-01-01,"upuus",1,"Yr1 (Next year)",7188,7966,1906,2797,12669,0,25,8,16,49,0
2009-05-01,"May",2010-01-01,"upsus",1,"Yr1 (Next year)",19135,13539,13647,33171,60357,0,96,112,277,485,0
2009-05-01,"May",2010-01-01,"midwus",1,"Yr1 (Next year)",4851,2830,2870,9647,15347,0,25,26,78,129,0
2009-05-01,"May",2010-01-01,"midwous",1,"Yr1 (Next year)",30660,11458,23347,46462,81267,0,130,270,547,947,0
2009-05-01,"May",2010-01-01,"ecous",1,"Yr1 (Next year)",4086,513,858,1323,2694,0,8,14,18,40,0
2009-05-01,"May",2010-01-01,"indus",1,"Yr1 (Next year)",11688,7139,2152,5608,14899,0,45,20,38,103,0
2009-05-01,"May",2010-01-01,"ustot",1,"Yr1 (Next year)",81502,45228,45133,99467,189828,0,335,451,976,1762,0
2009-12-01,"Dec",2010-01-01,"luxus",1,"Yr1 (Next year)",3894,3050,284,0,3334,0,12,1,0,13,0
2009-12-01,"Dec",2010-01-01,"upuus",1,"Yr1 (Next year)",7188,7337,430,0,7767,0,22,2,0,24,0
2009-12-01,"Dec",2010-01-01,"upsus",1,"Yr1 (Next year)",19135,22667,15201,0,37868,0,171,125,0,296,0
2009-12-01,"Dec",2010-01-01,"midwus",1,"Yr1 (Next year)",4851,5967,3877,0,9844,0,56,34,0,90,0
2009-12-01,"Dec",2010-01-01,"midwous",1,"Yr1 (Next year)",30660,31263,17042,0,48305,0,376,205,0,581,0
2009-12-01,"Dec",2010-01-01,"ecous",1,"Yr1 (Next year)",4086,3567,526,0,4093,0,43,6,0,49,0
2009-12-01,"Dec",2010-01-01,"indus",1,"Yr1 (Next year)",11688,10314,3303,0,13617,0,90,29,0,119,0
2009-12-01,"Dec",2010-01-01,"ustot",1,"Yr1 (Next year)",81502,84165,40663,0,124828,0,770,402,0,1172,0
2010-05-01,"May",2011-01-01,"luxus",1,"Yr1 (Next year)",1807,0,200,0,200,0,0,1,0,1,0
2010-05-01,"May",2011-01-01,"upuus",1,"Yr1 (Next year)",6002,2458,4134,285,6877,0,7,19,2,28,0
2010-05-01,"May",2011-01-01,"upsus",1,"Yr1 (Next year)",8955,3226,11394,9097,23717,0,23,93,77,193,0
2010-05-01,"May",2011-01-01,"midwus",1,"Yr1 (Next year)",NA,814,1715,7638,10167,0,5,16,61,82,0
2010-05-01,"May",2011-01-01,"midwous",1,"Yr1 (Next year)",NA,6276,26143,23276,55695,0,71,290,279,640,0
2010-05-01,"May",2011-01-01,"ecous",1,"Yr1 (Next year)",1745,818,815,191,1824,0,12,11,3,26,0
2010-05-01,"May",2011-01-01,"indus",1,"Yr1 (Next year)",3634,2945,2103,2868,7916,0,15,16,15,46,0
2010-05-01,"May",2011-01-01,"ustot",1,"Yr1 (Next year)",42107,16537,46504,43355,106396,0,133,446,437,1016,0
2010-12-01,"Dec",2011-01-01,"luxus",1,"Yr1 (Next year)",1807,0,0,0,0,0,0,0,0,0,0
2010-12-01,"Dec",2011-01-01,"upuus",1,"Yr1 (Next year)",6002,3287,761,125,4173,0,11,4,1,16,0
2010-12-01,"Dec",2011-01-01,"upsus",1,"Yr1 (Next year)",8955,9781,4050,851,14682,0,74,35,7,116,0
2010-12-01,"Dec",2011-01-01,"midwus",1,"Yr1 (Next year)",NA,3731,2713,1743,8187,0,35,25,14,74,0
2010-12-01,"Dec",2011-01-01,"midwous",1,"Yr1 (Next year)",NA,17130,19689,2828,39647,0,193,246,34,473,0
2010-12-01,"Dec",2011-01-01,"ecous",1,"Yr1 (Next year)",1745,1312,337,56,1705,0,18,4,1,23,0
2010-12-01,"Dec",2011-01-01,"indus",1,"Yr1 (Next year)",3634,4720,1704,929,7353,0,52,15,5,72,0
2010-12-01,"Dec",2011-01-01,"ustot",1,"Yr1 (Next year)",42107,39961,29254,6532,75747,0,383,329,62,774,0
2011-05-01,"May",2012-01-01,"luxus",1,"Yr1 (Next year)",208,820,0,594,1414,0,4,0,3,7,0
2011-05-01,"May",2012-01-01,"upuus",1,"Yr1 (Next year)",2548,1813,940,1579,4332,0,6,5,7,18,0
2011-05-01,"May",2012-01-01,"upsus",1,"Yr1 (Next year)",10050,6358,7543,8108,22009,0,33,61,68,162,0
2011-05-01,"May",2012-01-01,"upmus",1,"Yr1 (Next year)",16401,6046,16018,17981,40045,0,54,178,186,418,0
2011-05-01,"May",2012-01-01,"midus",1,"Yr1 (Next year)",3571,885,6227,6530,13642,0,11,79,79,169,0
2011-05-01,"May",2012-01-01,"ecous",1,"Yr1 (Next year)",2731,546,658,826,2030,0,8,8,9,25,0
2011-05-01,"May",2012-01-01,"indus",1,"Yr1 (Next year)",7084,3964,3041,2760,9765,0,21,14,17,52,0
2011-05-01,"May",2012-01-01,"ustot",1,"Yr1 (Next year)",42593,20432,34427,38378,93237,0,137,345,369,851,0
2011-12-01,"Dec",2012-01-01,"luxus",1,"Yr1 (Next year)",208,1003,149,0,1152,0,3,1,0,4,0
2011-12-01,"Dec",2012-01-01,"upuus",1,"Yr1 (Next year)",2548,3734,328,0,4062,0,13,2,0,15,0
2011-12-01,"Dec",2012-01-01,"upsus",1,"Yr1 (Next year)",10050,12894,5382,0,18276,0,86,43,0,129,0
2011-12-01,"Dec",2012-01-01,"upmus",1,"Yr1 (Next year)",16401,12973,11296,0,24269,0,129,120,0,249,0
2011-12-01,"Dec",2012-01-01,"midus",1,"Yr1 (Next year)",3571,2518,10661,0,13179,0,34,135,0,169,0
2011-12-01,"Dec",2012-01-01,"ecous",1,"Yr1 (Next year)",2731,734,319,0,1053,0,10,4,0,14,0
2011-12-01,"Dec",2012-01-01,"indus",1,"Yr1 (Next year)",7084,6515,1785,0,8300,0,56,13,0,69,0
2011-12-01,"Dec",2012-01-01,"ustot",1,"Yr1 (Next year)",42593,40371,29920,0,70291,0,331,318,0,649,0
2012-05-01,"May",2013-01-01,"luxus",1,"Yr1 (Next year)",693,505,610,0,1115,0,2,2,0,4,0
2012-05-01,"May",2013-01-01,"upuus",1,"Yr1 (Next year)",4458,4497,1259,250,6006,0,14,6,1,21,0
2012-05-01,"May",2013-01-01,"upsus",1,"Yr1 (Next year)",18571,8860,24335,4047,37242,0,61,198,31,290,0
2012-05-01,"May",2013-01-01,"upmus",1,"Yr1 (Next year)",22259,8205,26999,11300,46504,0,76,283,126,485,0
2012-05-01,"May",2013-01-01,"midus",1,"Yr1 (Next year)",5320,445,4479,4011,8935,0,6,57,50,113,0
2012-05-01,"May",2013-01-01,"ecous",1,"Yr1 (Next year)",3298,140,903,534,1577,0,2,13,6,21,0
2012-05-01,"May",2013-01-01,"indus",1,"Yr1 (Next year)",7011,3744,2829,707,7280,0,25,22,6,53,0
2012-05-01,"May",2013-01-01,"ustot",1,"Yr1 (Next year)",61610,26396,61414,20849,108659,0,186,581,220,987,0
2012-12-01,"Dec",2013-01-01,"luxus",1,"Yr1 (Next year)",693,900,0,0,900,0,5,0,0,5,0
2012-12-01,"Dec",2013-01-01,"upuus",1,"Yr1 (Next year)",4458,4423,148,0,4571,0,18,1,0,19,0
2012-12-01,"Dec",2013-01-01,"upsus",1,"Yr1 (Next year)",18571,17919,11643,0,29562,0,131,98,0,229,0
2012-12-01,"Dec",2013-01-01,"upmus",1,"Yr1 (Next year)",22259,18521,14911,0,33432,0,190,172,0,362,0
2012-12-01,"Dec",2013-01-01,"midus",1,"Yr1 (Next year)",5320,3076,3335,0,6411,0,41,44,0,85,0
2012-12-01,"Dec",2013-01-01,"ecous",1,"Yr1 (Next year)",3298,1016,1283,0,2299,0,15,16,0,31,0
2012-12-01,"Dec",2013-01-01,"indus",1,"Yr1 (Next year)",7011,7165,2961,0,10126,0,59,27,0,86,0
2012-12-01,"Dec",2013-01-01,"ustot",1,"Yr1 (Next year)",61610,53020,34281,0,87301,0,459,358,0,817,0
2013-05-01,"May",2014-01-01,"luxus",1,"Yr1 (Next year)",1032,2795,0,57,2852,0,5,0,1,6,0
2013-05-01,"May",2014-01-01,"upuus",1,"Yr1 (Next year)",4592,3474,1088,378,4940,0,14,6,2,22,0
2013-05-01,"May",2014-01-01,"upsus",1,"Yr1 (Next year)",24270,10096,9925,4199,24220,0,69,76,34,179,0
2013-05-01,"May",2014-01-01,"upmus",1,"Yr1 (Next year)",25855,7273,16787,9954,34014,0,68,177,111,356,0
2013-05-01,"May",2014-01-01,"midus",1,"Yr1 (Next year)",5522,331,3650,4225,8206,0,4,45,56,105,0
2013-05-01,"May",2014-01-01,"ecous",1,"Yr1 (Next year)",4326,98,122,173,393,0,2,2,2,6,0
2013-05-01,"May",2014-01-01,"indus",1,"Yr1 (Next year)",9546,3811,6329,1604,11744,0,25,34,15,74,0
2013-05-01,"May",2014-01-01,"ustot",1,"Yr1 (Next year)",75143,27878,37901,20590,86369,0,187,340,221,748,0
2013-12-01,"Dec",2014-01-01,"luxus",1,"Yr1 (Next year)",1032,2980,0,0,2980,0,6,0,0,6,0
2013-12-01,"Dec",2014-01-01,"upuus",1,"Yr1 (Next year)",4592,6189,0,0,6189,0,29,0,0,29,0
2013-12-01,"Dec",2014-01-01,"upsus",1,"Yr1 (Next year)",24270,24737,31,98,24866,0,192,1,1,194,0
2013-12-01,"Dec",2014-01-01,"upmus",1,"Yr1 (Next year)",25855,24705,102,346,25153,0,251,2,4,257,0
2013-12-01,"Dec",2014-01-01,"midus",1,"Yr1 (Next year)",5522,3961,374,167,4502,0,52,5,2,59,0
2013-12-01,"Dec",2014-01-01,"ecous",1,"Yr1 (Next year)",4326,1035,0,0,1035,0,15,0,0,15,0
2013-12-01,"Dec",2014-01-01,"indus",1,"Yr1 (Next year)",9546,7927,236,80,8243,0,60,4,2,66,0
2013-12-01,"Dec",2014-01-01,"ustot",1,"Yr1 (Next year)",75143,71534,743,691,72968,0,605,12,9,626,0
2014-05-01,"May",2015-01-01,"luxus",1,"Yr1 (Next year)",2152,1982,497,0,2479,0,4,3,0,7,0
2014-05-01,"May",2015-01-01,"upuus",1,"Yr1 (Next year)",7367,4654,2200,348,7202,0,22,12,2,36,0
2014-05-01,"May",2015-01-01,"upsus",1,"Yr1 (Next year)",31263,20265,21260,5119,46644,1417,140,169,43,352,8
2014-05-01,"May",2015-01-01,"upmus",1,"Yr1 (Next year)",31965,9365,32163,14138,55666,191,92,338,148,578,2
2014-05-01,"May",2015-01-01,"midus",1,"Yr1 (Next year)",7679,1736,8668,2878,13282,96,24,118,36,178,1
2014-05-01,"May",2015-01-01,"ecous",1,"Yr1 (Next year)",4290,204,694,634,1532,0,2,9,8,19,0
2014-05-01,"May",2015-01-01,"indus",1,"Yr1 (Next year)",10572,6241,9518,3407,19166,110,35,58,20,113,1
2014-05-01,"May",2015-01-01,"ustot",1,"Yr1 (Next year)",95288,44447,75000,26524,145971,1814,319,707,257,1283,12
2014-12-01,"Dec",2015-01-01,"luxus",1,"Yr1 (Next year)",2152,2569,0,0,2569,0,7,0,0,7,0
2014-12-01,"Dec",2015-01-01,"upuus",1,"Yr1 (Next year)",7367,9123,0,0,9123,0,41,0,0,41,0
2014-12-01,"Dec",2015-01-01,"upsus",1,"Yr1 (Next year)",31263,35895,232,0,36127,0,271,3,0,274,0
2014-12-01,"Dec",2015-01-01,"upmus",1,"Yr1 (Next year)",31965,32289,2349,0,34638,0,339,33,0,372,0
2014-12-01,"Dec",2015-01-01,"midus",1,"Yr1 (Next year)",7679,5660,892,0,6552,0,86,13,0,99,0
2014-12-01,"Dec",2015-01-01,"ecous",1,"Yr1 (Next year)",4290,655,457,0,1112,0,9,7,0,16,0
2014-12-01,"Dec",2015-01-01,"indus",1,"Yr1 (Next year)",10572,12493,787,24,13304,0,87,7,1,95,0
2014-12-01,"Dec",2015-01-01,"ustot",1,"Yr1 (Next year)",95288,98684,4717,24,103425,0,840,63,1,904,0
2015-05-01,"May",2016-01-01,"luxus",1,"Yr1 (Next year)",NA,1265,1285,435,2985,0,7,2,2,11,0
2015-05-01,"May",2016-01-01,"upuus",1,"Yr1 (Next year)",NA,5567,3066,281,8914,0,19,16,1,36,0
2015-05-01,"May",2016-01-01,"upsus",1,"Yr1 (Next year)",NA,18857,26765,5751,51373,0,128,216,49,393,0
2015-05-01,"May",2016-01-01,"upmus",1,"Yr1 (Next year)",NA,12969,42952,9836,65757,0,129,442,112,683,0
2015-05-01,"May",2016-01-01,"midus",1,"Yr1 (Next year)",NA,924,9440,4446,14810,0,12,122,62,196,0
2015-05-01,"May",2016-01-01,"ecous",1,"Yr1 (Next year)",NA,280,610,462,1352,0,3,9,6,18,0
2015-05-01,"May",2016-01-01,"indus",1,"Yr1 (Next year)",NA,4730,7471,3885,16086,0,28,55,24,107,0
2015-05-01,"May",2016-01-01,"ustot",1,"Yr1 (Next year)",NA,44592,91589,25096,161277,0,326,862,256,1444,0
2015-12-01,"Dec",2016-01-01,"luxus",1,"Yr1 (Next year)",NA,3170,0,0,3170,0,14,0,0,14,0
2015-12-01,"Dec",2016-01-01,"upuus",1,"Yr1 (Next year)",NA,7018,0,0,7018,0,30,0,0,30,0
2015-12-01,"Dec",2016-01-01,"upsus",1,"Yr1 (Next year)",NA,41230,318,0,41548,0,295,5,0,300,0
2015-12-01,"Dec",2016-01-01,"upmus",1,"Yr1 (Next year)",NA,42946,2075,0,45021,0,441,28,0,469,0
2015-12-01,"Dec",2016-01-01,"midus",1,"Yr1 (Next year)",NA,5050,3569,0,8619,0,68,51,0,119,0
2015-12-01,"Dec",2016-01-01,"ecous",1,"Yr1 (Next year)",NA,1512,139,0,1651,0,18,2,0,20,0
2015-12-01,"Dec",2016-01-01,"indus",1,"Yr1 (Next year)",NA,11125,430,0,11555,0,85,6,0,91,0
2015-12-01,"Dec",2016-01-01,"ustot",1,"Yr1 (Next year)",NA,112051,6531,0,118582,0,951,92,0,1043,0
2016-05-01,"May",2017-01-01,"luxus",1,"Yr1 (Next year)",NA,3025,220,180,3425,0,7,1,1,9,0
2016-05-01,"May",2017-01-01,"upuus",1,"Yr1 (Next year)",NA,6965,4300,2115,13380,0,28,20,9,57,0
2016-05-01,"May",2017-01-01,"upsus",1,"Yr1 (Next year)",NA,23427,30322,10554,64303,0,164,245,89,498,0
2016-05-01,"May",2017-01-01,"upmus",1,"Yr1 (Next year)",NA,18729,39797,24033,82559,0,184,407,254,845,0
2016-05-01,"May",2017-01-01,"midus",1,"Yr1 (Next year)",NA,798,4204,11653,16655,0,9,53,149,211,0
2016-05-01,"May",2017-01-01,"ecous",1,"Yr1 (Next year)",NA,139,274,348,761,0,2,3,5,10,0
2016-05-01,"May",2017-01-01,"indus",1,"Yr1 (Next year)",NA,6946,12388,4078,23412,0,41,74,23,138,0
2016-05-01,"May",2017-01-01,"ustot",1,"Yr1 (Next year)",NA,60029,91505,52961,204495,0,435,803,530,1768,0
2007-05-01,"May",2009-01-01,"luxus",2,"Yr2 (Year after next)",4046,1796,1323,2039,5158,0,7,5,9,21,0
2007-05-01,"May",2009-01-01,"upuus",2,"Yr2 (Year after next)",11039,4873,2029,6404,13306,2633,11,8,23,42,10
2007-05-01,"May",2009-01-01,"upsus",2,"Yr2 (Year after next)",41006,881,1474,9776,12131,9904,7,12,73,92,84
2007-05-01,"May",2009-01-01,"midwus",2,"Yr2 (Year after next)",8272,0,120,3044,3164,2048,0,1,25,26,17
2007-05-01,"May",2009-01-01,"midwous",2,"Yr2 (Year after next)",59842,238,614,6528,7380,12457,3,8,73,84,147
2007-05-01,"May",2009-01-01,"ecous",2,"Yr2 (Year after next)",9607,200,0,100,300,318,1,0,1,2,3
2007-05-01,"May",2009-01-01,"indus",2,"Yr2 (Year after next)",14629,7272,1988,17801,27061,3338,14,11,47,72,9
2007-05-01,"May",2009-01-01,"ustot",2,"Yr2 (Year after next)",148441,15260,7548,45692,68500,30698,43,45,251,339,270
2007-12-01,"Dec",2009-01-01,"luxus",2,"Yr2 (Year after next)",4046,3096,0,1815,4911,120,17,0,9,26,1
2007-12-01,"Dec",2009-01-01,"upuus",2,"Yr2 (Year after next)",11039,6924,5439,8695,21058,454,20,26,33,79,2
2007-12-01,"Dec",2009-01-01,"upsus",2,"Yr2 (Year after next)",41006,7596,9475,38219,55290,6686,55,74,305,434,55
2007-12-01,"Dec",2009-01-01,"midwus",2,"Yr2 (Year after next)",8272,968,1043,6888,8899,4429,8,9,56,73,38
2007-12-01,"Dec",2009-01-01,"midwous",2,"Yr2 (Year after next)",59842,4197,7161,30945,42303,15835,46,79,351,476,190
2007-12-01,"Dec",2009-01-01,"ecous",2,"Yr2 (Year after next)",9607,363,1073,1125,2561,302,3,14,16,33,3
2007-12-01,"Dec",2009-01-01,"indus",2,"Yr2 (Year after next)",14629,7084,4242,12899,24225,2089,44,19,70,133,7
2007-12-01,"Dec",2009-01-01,"ustot",2,"Yr2 (Year after next)",148441,30228,28433,100586,159247,29915,193,221,840,1254,296
2008-05-01,"May",2010-01-01,"luxus",2,"Yr2 (Year after next)",3894,537,805,1067,2409,425,2,3,3,8,3
2008-05-01,"May",2010-01-01,"upuus",2,"Yr2 (Year after next)",7188,3542,1070,7758,12370,4493,7,4,25,36,21
2008-05-01,"May",2010-01-01,"upsus",2,"Yr2 (Year after next)",19135,1402,984,20195,22581,8388,9,8,155,172,53
2008-05-01,"May",2010-01-01,"midwus",2,"Yr2 (Year after next)",4851,0,0,5265,5265,1075,0,0,41,41,9
2008-05-01,"May",2010-01-01,"midwous",2,"Yr2 (Year after next)",30660,264,498,18712,19474,8501,3,5,214,222,96
2008-05-01,"May",2010-01-01,"ecous",2,"Yr2 (Year after next)",4086,0,0,205,205,366,0,0,3,3,5
2008-05-01,"May",2010-01-01,"indus",2,"Yr2 (Year after next)",11688,10007,1538,7679,19224,11696,12,5,28,45,38
2008-05-01,"May",2010-01-01,"ustot",2,"Yr2 (Year after next)",81502,15752,4895,60881,81528,34944,33,25,469,527,225
2008-12-01,"Dec",2010-01-01,"luxus",2,"Yr2 (Year after next)",3894,1229,150,1837,3216,0,5,1,7,13,2
2008-12-01,"Dec",2010-01-01,"upuus",2,"Yr2 (Year after next)",7188,5635,1668,8951,16254,742,14,7,41,62,3
2008-12-01,"Dec",2010-01-01,"upsus",2,"Yr2 (Year after next)",19135,7554,10274,58023,75851,1189,47,81,469,597,10
2008-12-01,"Dec",2010-01-01,"midwus",2,"Yr2 (Year after next)",4851,630,299,14050,14979,140,4,3,114,121,1
2008-12-01,"Dec",2010-01-01,"midwous",2,"Yr2 (Year after next)",30660,2384,5185,70574,78143,2015,25,56,813,894,25
2008-12-01,"Dec",2010-01-01,"ecous",2,"Yr2 (Year after next)",4086,201,0,1068,1269,297,2,0,16,18,4
2008-12-01,"Dec",2010-01-01,"indus",2,"Yr2 (Year after next)",11688,7261,1993,8432,17686,8247,25,14,45,84,17
2008-12-01,"Dec",2010-01-01,"ustot",2,"Yr2 (Year after next)",81502,24894,19569,162935,207398,12630,122,162,1505,1789,62
2009-05-01,"May",2011-01-01,"luxus",2,"Yr2 (Year after next)",1807,413,0,2492,2905,754,2,0,9,11,3
2009-05-01,"May",2011-01-01,"upuus",2,"Yr2 (Year after next)",6002,1645,1386,5374,8405,1455,3,4,19,26,8
2009-05-01,"May",2011-01-01,"upsus",2,"Yr2 (Year after next)",8955,1237,1396,22957,25590,5232,7,9,174,190,39
2009-05-01,"May",2011-01-01,"midwus",2,"Yr2 (Year after next)",NA,0,0,3727,3727,2144,0,0,26,26,17
2009-05-01,"May",2011-01-01,"midwous",2,"Yr2 (Year after next)",NA,0,541,17305,17846,7476,0,5,187,192,84
2009-05-01,"May",2011-01-01,"ecous",2,"Yr2 (Year after next)",1745,703,0,484,1187,70,9,0,6,15,1
2009-05-01,"May",2011-01-01,"indus",2,"Yr2 (Year after next)",3634,518,1091,9077,10686,2004,4,6,29,39,12
2009-05-01,"May",2011-01-01,"ustot",2,"Yr2 (Year after next)",42107,4516,4414,61416,70346,19135,25,24,450,499,164
2009-12-01,"Dec",2011-01-01,"luxus",2,"Yr2 (Year after next)",1807,230,797,1123,2150,0,1,3,5,9,0
2009-12-01,"Dec",2011-01-01,"upuus",2,"Yr2 (Year after next)",6002,1912,2040,3640,7592,247,4,9,19,32,1
2009-12-01,"Dec",2011-01-01,"upsus",2,"Yr2 (Year after next)",8955,2051,6969,31302,40322,962,14,51,252,317,9
2009-12-01,"Dec",2011-01-01,"midwus",2,"Yr2 (Year after next)",NA,0,352,9547,9899,923,0,3,75,78,7
2009-12-01,"Dec",2011-01-01,"midwous",2,"Yr2 (Year after next)",NA,1993,5743,52123,59859,3261,22,59,595,676,37
2009-12-01,"Dec",2011-01-01,"ecous",2,"Yr2 (Year after next)",1745,1281,1177,508,2966,56,18,14,9,41,1
2009-12-01,"Dec",2011-01-01,"indus",2,"Yr2 (Year after next)",3634,1962,169,5911,8042,552,8,1,34,43,3
2009-12-01,"Dec",2011-01-01,"ustot",2,"Yr2 (Year after next)",42107,9429,17247,104154,130830,6001,67,140,989,1196,58
2010-05-01,"May",2012-01-01,"luxus",2,"Yr2 (Year after next)",208,445,0,934,1379,535,2,0,3,5,3
2010-05-01,"May",2012-01-01,"upuus",2,"Yr2 (Year after next)",2548,1016,2440,1291,4747,220,1,10,6,17,1
2010-05-01,"May",2012-01-01,"upsus",2,"Yr2 (Year after next)",10050,784,6666,4634,12084,1739,3,51,36,90,14
2010-05-01,"May",2012-01-01,"midwus",2,"Yr2 (Year after next)",NA,398,143,2196,2737,570,2,1,17,20,5
2010-05-01,"May",2012-01-01,"midwous",2,"Yr2 (Year after next)",NA,0,8382,7918,16300,2896,0,85,88,173,37
2010-05-01,"May",2012-01-01,"ecous",2,"Yr2 (Year after next)",2731,0,0,60,60,250,0,0,1,1,3
2010-05-01,"May",2012-01-01,"indus",2,"Yr2 (Year after next)",7084,318,3951,2922,7191,580,2,7,18,27,5
2010-05-01,"May",2012-01-01,"ustot",2,"Yr2 (Year after next)",42593,2961,21582,19955,44498,6790,10,154,169,333,68
2010-12-01,"Dec",2012-01-01,"luxus",2,"Yr2 (Year after next)",208,655,525,594,1774,0,3,1,3,7,0
2010-12-01,"Dec",2012-01-01,"upuus",2,"Yr2 (Year after next)",2548,2171,799,2153,5123,604,4,2,10,16,3
2010-12-01,"Dec",2012-01-01,"upsus",2,"Yr2 (Year after next)",10050,2380,2591,21611,26582,388,12,16,181,209,4
2010-12-01,"Dec",2012-01-01,"midwus",2,"Yr2 (Year after next)",NA,464,157,7905,8526,378,2,1,60,63,4
2010-12-01,"Dec",2012-01-01,"midwous",2,"Yr2 (Year after next)",NA,1843,2326,39153,43322,1400,19,26,432,477,17
2010-12-01,"Dec",2012-01-01,"ecous",2,"Yr2 (Year after next)",2731,236,489,430,1155,0,3,6,6,15,0
2010-12-01,"Dec",2012-01-01,"indus",2,"Yr2 (Year after next)",7084,2193,3028,3250,8471,0,7,13,23,43,0
2010-12-01,"Dec",2012-01-01,"ustot",2,"Yr2 (Year after next)",42593,9942,9915,75096,94953,2770,50,65,715,830,28
2011-05-01,"May",2013-01-01,"luxus",2,"Yr2 (Year after next)",693,0,320,0,320,285,0,1,0,1,1
2011-05-01,"May",2013-01-01,"upuus",2,"Yr2 (Year after next)",4458,500,800,3048,4348,2465,1,1,13,15,12
2011-05-01,"May",2013-01-01,"upsus",2,"Yr2 (Year after next)",18571,691,786,11379,12856,5332,4,3,89,96,41
2011-05-01,"May",2013-01-01,"upmus",2,"Yr2 (Year after next)",22259,287,442,19111,19840,6676,3,4,197,204,73
2011-05-01,"May",2013-01-01,"midus",2,"Yr2 (Year after next)",5320,0,0,523,523,1453,0,0,7,7,18
2011-05-01,"May",2013-01-01,"ecous",2,"Yr2 (Year after next)",3298,0,0,217,217,569,0,0,3,3,6
2011-05-01,"May",2013-01-01,"indus",2,"Yr2 (Year after next)",7011,168,500,1184,1852,846,1,2,7,10,7
2011-05-01,"May",2013-01-01,"ustot",2,"Yr2 (Year after next)",61610,1646,2848,35462,39956,17626,9,11,316,336,158
2011-12-01,"Dec",2013-01-01,"luxus",2,"Yr2 (Year after next)",693,210,840,261,1311,0,1,3,2,6,0
2011-12-01,"Dec",2013-01-01,"upuus",2,"Yr2 (Year after next)",4458,2306,2906,1010,6222,0,7,13,4,24,0
2011-12-01,"Dec",2013-01-01,"upsus",2,"Yr2 (Year after next)",18571,3189,22384,11959,37532,130,20,178,94,292,1
2011-12-01,"Dec",2013-01-01,"upmus",2,"Yr2 (Year after next)",22259,2864,18307,11194,32365,1001,23,185,126,334,11
2011-12-01,"Dec",2013-01-01,"midus",2,"Yr2 (Year after next)",5320,42,2863,3367,6272,274,1,38,43,82,3
2011-12-01,"Dec",2013-01-01,"ecous",2,"Yr2 (Year after next)",3298,140,904,335,1379,319,2,12,4,18,3
2011-12-01,"Dec",2013-01-01,"indus",2,"Yr2 (Year after next)",7011,1394,3915,809,6118,102,10,21,6,37,1
2011-12-01,"Dec",2013-01-01,"ustot",2,"Yr2 (Year after next)",61610,10145,52119,28935,91199,1826,64,450,279,793,19
2012-05-01,"May",2014-01-01,"luxus",2,"Yr2 (Year after next)",1032,888,0,350,1238,190,2,0,1,3,1
2012-05-01,"May",2014-01-01,"upuus",2,"Yr2 (Year after next)",4592,1175,3636,531,5342,130,1,18,3,22,2
2012-05-01,"May",2014-01-01,"upsus",2,"Yr2 (Year after next)",24270,362,9764,7932,18058,3229,2,71,58,131,25
2012-05-01,"May",2014-01-01,"upmus",2,"Yr2 (Year after next)",25855,155,9410,9900,19465,4931,2,95,101,198,53
2012-05-01,"May",2014-01-01,"midus",2,"Yr2 (Year after next)",5522,0,379,690,1069,293,0,5,9,14,4
2012-05-01,"May",2014-01-01,"ecous",2,"Yr2 (Year after next)",4326,0,0,52,52,195,0,0,1,1,2
2012-05-01,"May",2014-01-01,"indus",2,"Yr2 (Year after next)",9546,223,1491,937,2651,537,2,9,7,18,4
2012-05-01,"May",2014-01-01,"ustot",2,"Yr2 (Year after next)",75143,2803,24680,20392,47875,9505,9,198,180,387,91
2012-12-01,"Dec",2014-01-01,"luxus",2,"Yr2 (Year after next)",1032,2234,298,350,2882,0,2,1,1,4,0
2012-12-01,"Dec",2014-01-01,"upuus",2,"Yr2 (Year after next)",4592,2397,2452,0,4849,0,8,12,0,20,0
2012-12-01,"Dec",2014-01-01,"upsus",2,"Yr2 (Year after next)",24270,4276,11811,10865,26952,0,26,90,85,201,0
2012-12-01,"Dec",2014-01-01,"upmus",2,"Yr2 (Year after next)",25855,1754,15268,19706,36728,0,16,150,210,376,0
2012-12-01,"Dec",2014-01-01,"midus",2,"Yr2 (Year after next)",5522,267,1133,4628,6028,0,3,13,58,74,0
2012-12-01,"Dec",2014-01-01,"ecous",2,"Yr2 (Year after next)",4326,44,219,330,593,0,1,3,4,8,0
2012-12-01,"Dec",2014-01-01,"indus",2,"Yr2 (Year after next)",9546,1266,4652,1966,7884,0,7,26,19,52,0
2012-12-01,"Dec",2014-01-01,"ustot",2,"Yr2 (Year after next)",75143,12238,35833,37845,85916,0,63,295,377,735,0
2013-05-01,"May",2015-01-01,"luxus",2,"Yr2 (Year after next)",2152,1412,0,0,1412,0,2,0,0,2,0
2013-05-01,"May",2015-01-01,"upuus",2,"Yr2 (Year after next)",7367,650,2293,1991,4934,205,2,10,7,19,1
2013-05-01,"May",2015-01-01,"upsus",2,"Yr2 (Year after next)",31263,140,11053,5947,17140,562,1,79,38,118,5
2013-05-01,"May",2015-01-01,"upmus",2,"Yr2 (Year after next)",31965,198,7084,8785,16067,848,2,74,86,162,10
2013-05-01,"May",2015-01-01,"midus",2,"Yr2 (Year after next)",7679,65,100,1625,1790,414,1,1,21,23,5
2013-05-01,"May",2015-01-01,"ecous",2,"Yr2 (Year after next)",4290,0,0,157,157,100,0,0,2,2,1
2013-05-01,"May",2015-01-01,"indus",2,"Yr2 (Year after next)",10572,450,4190,2467,7107,1662,2,16,12,30,6
2013-05-01,"May",2015-01-01,"ustot",2,"Yr2 (Year after next)",95288,2915,24720,20972,48607,3791,10,180,166,356,28
2013-12-01,"Dec",2015-01-01,"luxus",2,"Yr2 (Year after next)",2152,1412,57,190,1659,0,2,1,1,4,0
2013-12-01,"Dec",2015-01-01,"upuus",2,"Yr2 (Year after next)",7367,2043,4809,1361,8213,0,7,25,5,37,0
2013-12-01,"Dec",2015-01-01,"upsus",2,"Yr2 (Year after next)",31263,6742,33609,6931,47282,0,40,265,60,365,0
2013-12-01,"Dec",2015-01-01,"upmus",2,"Yr2 (Year after next)",31965,3264,36901,17373,57538,0,30,389,185,604,0
2013-12-01,"Dec",2015-01-01,"midus",2,"Yr2 (Year after next)",7679,90,11330,3403,14823,0,1,152,44,197,0
2013-12-01,"Dec",2015-01-01,"ecous",2,"Yr2 (Year after next)",4290,80,345,812,1237,0,1,5,11,17,0
2013-12-01,"Dec",2015-01-01,"indus",2,"Yr2 (Year after next)",10572,4103,9366,4537,18006,0,15,50,26,91,0
2013-12-01,"Dec",2015-01-01,"ustot",2,"Yr2 (Year after next)",95288,17734,96417,34607,148758,0,96,887,332,1315,0
2014-05-01,"May",2016-01-01,"luxus",2,"Yr2 (Year after next)",NA,265,1763,549,2577,0,2,3,2,7,0
2014-05-01,"May",2016-01-01,"upuus",2,"Yr2 (Year after next)",NA,600,3222,1035,4857,600,2,11,5,18,1
2014-05-01,"May",2016-01-01,"upsus",2,"Yr2 (Year after next)",NA,1491,13967,12256,27714,674,5,98,96,199,5
2014-05-01,"May",2016-01-01,"upmus",2,"Yr2 (Year after next)",NA,507,5392,21280,27179,0,3,56,214,273,0
2014-05-01,"May",2016-01-01,"midus",2,"Yr2 (Year after next)",NA,0,326,2683,3009,0,0,4,42,46,0
2014-05-01,"May",2016-01-01,"ecous",2,"Yr2 (Year after next)",NA,0,0,233,233,0,0,0,3,3,0
2014-05-01,"May",2016-01-01,"indus",2,"Yr2 (Year after next)",NA,1476,7253,4199,12928,740,7,23,16,46,3
2014-05-01,"May",2016-01-01,"ustot",2,"Yr2 (Year after next)",NA,4339,31923,42235,78497,2014,19,195,378,592,9
2014-12-01,"Dec",2016-01-01,"luxus",2,"Yr2 (Year after next)",NA,751,1509,0,2260,0,5,3,0,8,0
2014-12-01,"Dec",2016-01-01,"upuus",2,"Yr2 (Year after next)",NA,3700,4268,1471,9439,696,11,22,8,41,4
2014-12-01,"Dec",2016-01-01,"upsus",2,"Yr2 (Year after next)",NA,8076,30337,15226,53639,2087,47,236,123,406,18
2014-12-01,"Dec",2016-01-01,"upmus",2,"Yr2 (Year after next)",NA,2313,34290,30308,66911,407,18,352,312,682,4
2014-12-01,"Dec",2016-01-01,"midus",2,"Yr2 (Year after next)",NA,181,8030,5151,13362,0,2,99,78,179,0
2014-12-01,"Dec",2016-01-01,"ecous",2,"Yr2 (Year after next)",NA,0,424,444,868,0,0,4,7,11,0
2014-12-01,"Dec",2016-01-01,"indus",2,"Yr2 (Year after next)",NA,3186,12952,3744,19882,930,14,58,29,101,5
2014-12-01,"Dec",2016-01-01,"ustot",2,"Yr2 (Year after next)",NA,18207,91810,56344,166361,4120,97,774,557,1428,31
2015-05-01,"May",2017-01-01,"luxus",2,"Yr2 (Year after next)",NA,2385,670,1571,4626,0,4,2,5,11,0
2015-05-01,"May",2017-01-01,"upuus",2,"Yr2 (Year after next)",NA,2211,6515,3615,12341,0,7,26,13,46,0
2015-05-01,"May",2017-01-01,"upsus",2,"Yr2 (Year after next)",NA,844,27358,12803,41005,0,7,206,98,311,0
2015-05-01,"May",2017-01-01,"upmus",2,"Yr2 (Year after next)",NA,450,18644,16931,36025,0,3,188,172,363,0
2015-05-01,"May",2017-01-01,"midus",2,"Yr2 (Year after next)",NA,59,80,6056,6195,0,1,1,80,82,0
2015-05-01,"May",2017-01-01,"ecous",2,"Yr2 (Year after next)",NA,0,291,612,903,0,0,2,6,8,0
2015-05-01,"May",2017-01-01,"indus",2,"Yr2 (Year after next)",NA,1355,4512,4141,10008,0,3,17,17,37,0
2015-05-01,"May",2017-01-01,"ustot",2,"Yr2 (Year after next)",NA,7304,58070,45729,111103,0,25,442,391,858,0
2015-12-01,"Dec",2017-01-01,"luxus",2,"Yr2 (Year after next)",NA,3395,1188,180,4763,0,8,4,1,13,0
2015-12-01,"Dec",2017-01-01,"upuus",2,"Yr2 (Year after next)",NA,4218,11238,2200,17656,0,17,48,10,75,0
2015-12-01,"Dec",2017-01-01,"upsus",2,"Yr2 (Year after next)",NA,6954,46262,15066,68282,0,51,367,121,539,0
2015-12-01,"Dec",2017-01-01,"upmus",2,"Yr2 (Year after next)",NA,4833,53633,23772,82238,0,44,546,249,839,0
2015-12-01,"Dec",2017-01-01,"midus",2,"Yr2 (Year after next)",NA,271,5299,11428,16998,0,3,63,151,217,0
2015-12-01,"Dec",2017-01-01,"ecous",2,"Yr2 (Year after next)",NA,0,1248,984,2232,0,0,10,8,18,0
2015-12-01,"Dec",2017-01-01,"indus",2,"Yr2 (Year after next)",NA,2335,12833,5887,21055,0,10,74,29,113,0
2015-12-01,"Dec",2017-01-01,"ustot",2,"Yr2 (Year after next)",NA,22006,131701,59517,213224,0,133,1112,569,1814,0
2016-05-01,"May",2018-01-01,"luxus",2,"Yr2 (Year after next)",NA,897,2252,817,3966,0,4,9,3,16,0
2016-05-01,"May",2018-01-01,"upuus",2,"Yr2 (Year after next)",NA,4377,10532,3527,18436,0,17,47,15,79,0
2016-05-01,"May",2018-01-01,"upsus",2,"Yr2 (Year after next)",NA,8856,26573,12065,47494,0,64,207,100,371,0
2016-05-01,"May",2018-01-01,"upmus",2,"Yr2 (Year after next)",NA,13060,20492,25400,58952,0,121,198,253,572,0
2016-05-01,"May",2018-01-01,"midus",2,"Yr2 (Year after next)",NA,0,0,7224,7224,0,0,0,88,88,0
2016-05-01,"May",2018-01-01,"ecous",2,"Yr2 (Year after next)",NA,0,85,0,85,0,0,1,0,1,0
2016-05-01,"May",2018-01-01,"indus",2,"Yr2 (Year after next)",NA,4289,2882,4040,11211,0,5,11,25,41,0
2016-05-01,"May",2018-01-01,"ustot",2,"Yr2 (Year after next)",NA,31479,62816,53073,147368,0,211,473,484,1168,0
2007-05-01,"May",2010-01-01,"luxus",3,"Yr3 and later",3894,0,216,1603,1819,500,0,1,11,12,2
2007-05-01,"May",2010-01-01,"upuus",3,"Yr3 and later",7188,1376,590,10479,12445,6686,2,3,49,54,16
2007-05-01,"May",2010-01-01,"upsus",3,"Yr3 and later",19135,204,312,5444,5960,8539,3,3,63,69,63
2007-05-01,"May",2010-01-01,"midwus",3,"Yr3 and later",4851,132,150,1459,1741,241,1,1,20,22,4
2007-05-01,"May",2010-01-01,"midwous",3,"Yr3 and later",30660,159,811,4578,5548,1628,2,9,79,90,26
2007-05-01,"May",2010-01-01,"ecous",3,"Yr3 and later",4086,0,249,2742,2991,100,1,23,150,174,2
2007-05-01,"May",2010-01-01,"indus",3,"Yr3 and later",11688,684,2361,121437,124482,33331,6,24,1149,1179,269
2007-05-01,"May",2010-01-01,"ustot",3,"Yr3 and later",81502,2555,4689,147742,154986,51025,15,64,1521,1600,382
2007-12-01,"Dec",2010-01-01,"luxus",3,"Yr3",3894,1367,200,225,1792,0,5,1,2,8,0
2007-12-01,"Dec",2010-01-01,"upuus",3,"Yr3",7188,3275,751,5346,9372,384,5,3,15,23,2
2007-12-01,"Dec",2010-01-01,"upsus",3,"Yr3",19135,164,661,2328,3153,5548,1,3,17,21,34
2007-12-01,"Dec",2010-01-01,"midwus",3,"Yr3",4851,0,0,120,120,1532,0,0,1,1,12
2007-12-01,"Dec",2010-01-01,"midwous",3,"Yr3",30660,0,0,738,738,2816,0,0,6,6,30
2007-12-01,"Dec",2010-01-01,"ecous",3,"Yr3",4086,0,0,100,100,0,0,0,1,1,0
2007-12-01,"Dec",2010-01-01,"indus",3,"Yr3",11688,9821,1125,11626,22572,3230,12,3,35,50,11
2007-12-01,"Dec",2010-01-01,"ustot",3,"Yr3",81502,14627,2737,20483,37847,13510,23,10,77,110,89
2008-05-01,"May",2011-01-01,"luxus",3,"Yr3 and later",1807,769,0,2520,3289,3447,3,1,14,18,13
2008-05-01,"May",2011-01-01,"upuus",3,"Yr3 and later",6002,1005,1190,8134,10329,10705,1,5,32,38,20
2008-05-01,"May",2011-01-01,"upsus",3,"Yr3 and later",8955,0,1189,6913,8102,7472,0,9,87,96,57
2008-05-01,"May",2011-01-01,"midwus",3,"Yr3 and later",NA,0,206,2029,2235,1546,1,4,29,34,11
2008-05-01,"May",2011-01-01,"midwous",3,"Yr3 and later",NA,0,649,7551,8200,5940,1,14,130,145,83
2008-05-01,"May",2011-01-01,"ecous",3,"Yr3 and later",1745,125,6115,5028,11268,1581,2,73,86,161,24
2008-05-01,"May",2011-01-01,"indus",3,"Yr3 and later",3634,2137,2798,131036,135971,91989,5,30,1219,1254,473
2008-05-01,"May",2011-01-01,"ustot",3,"Yr3 and later",42107,4036,12147,163211,179394,122680,13,136,1597,1746,681
2008-12-01,"Dec",2011-01-01,"luxus",3,"Yr3",1807,517,225,2005,2747,2363,2,2,8,12,9
2008-12-01,"Dec",2011-01-01,"upuus",3,"Yr3",6002,1530,502,3408,5440,8325,3,2,8,13,24
2008-12-01,"Dec",2011-01-01,"upsus",3,"Yr3",8955,0,844,1295,2139,8961,0,5,7,12,62
2008-12-01,"Dec",2011-01-01,"midwus",3,"Yr3",NA,0,0,245,245,2918,0,0,2,2,21
2008-12-01,"Dec",2011-01-01,"midwous",3,"Yr3",NA,0,0,109,109,8234,0,0,1,1,90
2008-12-01,"Dec",2011-01-01,"ecous",3,"Yr3",1745,0,0,102,102,100,0,0,1,1,1
2008-12-01,"Dec",2011-01-01,"indus",3,"Yr3",3634,2350,445,4850,7645,6071,3,3,8,14,28
2008-12-01,"Dec",2011-01-01,"ustot",3,"Yr3",42107,4397,2016,12014,18427,36972,8,12,35,55,235
2009-05-01,"May",2012-01-01,"luxus",3,"Yr3 and later",208,0,509,650,1159,2683,0,4,5,9,14
2009-05-01,"May",2012-01-01,"upuus",3,"Yr3 and later",2548,0,560,3317,3877,12888,0,2,19,21,32
2009-05-01,"May",2012-01-01,"upsus",3,"Yr3 and later",10050,204,2722,10219,13145,7524,1,23,106,130,58
2009-05-01,"May",2012-01-01,"midwus",3,"Yr3 and later",NA,0,1101,2519,3620,2549,0,12,46,58,22
2009-05-01,"May",2012-01-01,"midwous",3,"Yr3 and later",NA,150,5451,11792,17393,5716,2,77,182,261,79
2009-05-01,"May",2012-01-01,"ecous",3,"Yr3 and later",2731,0,2597,4539,7136,972,1,35,87,123,17
2009-05-01,"May",2012-01-01,"indus",3,"Yr3 and later",7084,741,3829,103791,108361,71995,15,31,1048,1094,466
2009-05-01,"May",2012-01-01,"ustot",3,"Yr3 and later",42593,1095,16769,136827,154691,104327,19,184,1493,1696,688
2009-12-01,"Dec",2012-01-01,"luxus",3,"Yr3",208,445,0,0,445,791,2,0,0,2,4
2009-12-01,"Dec",2012-01-01,"upuus",3,"Yr3",2548,1316,0,1529,2845,1577,2,0,3,5,8
2009-12-01,"Dec",2012-01-01,"upsus",3,"Yr3",10050,204,541,0,745,7547,1,4,0,5,56
2009-12-01,"Dec",2012-01-01,"midwus",3,"Yr3",NA,48,0,100,148,1918,1,0,1,2,16
2009-12-01,"Dec",2012-01-01,"midwous",3,"Yr3",NA,119,0,0,119,10067,1,0,0,1,109
2009-12-01,"Dec",2012-01-01,"ecous",3,"Yr3",2731,0,0,0,0,250,0,0,0,0,3
2009-12-01,"Dec",2012-01-01,"indus",3,"Yr3",7084,0,649,409,1058,6050,0,3,1,4,15
2009-12-01,"Dec",2012-01-01,"ustot",3,"Yr3",42593,2132,1190,2038,5360,28200,7,7,5,19,211
2010-05-01,"May",2013-01-01,"luxus",3,"Yr3 and later",693,210,0,2439,2649,1010,1,1,10,12,5
2010-05-01,"May",2013-01-01,"upuus",3,"Yr3 and later",4458,170,2869,3216,6255,13753,1,6,14,21,36
2010-05-01,"May",2013-01-01,"upsus",3,"Yr3 and later",18571,272,8897,23808,32977,12506,2,75,198,275,96
2010-05-01,"May",2013-01-01,"midwus",3,"Yr3 and later",NA,0,765,2172,2937,914,0,11,33,44,10
2010-05-01,"May",2013-01-01,"midwous",3,"Yr3 and later",NA,0,6100,16841,22941,6215,0,77,209,286,77
2010-05-01,"May",2013-01-01,"ecous",3,"Yr3 and later",3298,100,757,1425,2282,603,2,15,37,54,30
2010-05-01,"May",2013-01-01,"indus",3,"Yr3 and later",7011,196,4445,88520,93161,58064,5,51,855,911,404
2010-05-01,"May",2013-01-01,"ustot",3,"Yr3 and later",61610,948,23833,138421,163202,93065,11,236,1356,1603,658
2010-12-01,"Dec",2013-01-01,"luxus",3,"Yr3",693,0,0,0,0,285,0,0,0,0,1
2010-12-01,"Dec",2013-01-01,"upuus",3,"Yr3",4458,0,1350,0,1350,5357,0,2,0,2,24
2010-12-01,"Dec",2013-01-01,"upsus",3,"Yr3",18571,0,117,971,1088,7364,0,1,5,6,57
2010-12-01,"Dec",2013-01-01,"midwus",3,"Yr3",NA,0,0,0,0,1016,0,0,0,0,10
2010-12-01,"Dec",2013-01-01,"midwous",3,"Yr3",NA,0,80,0,80,9279,0,1,0,1,99
2010-12-01,"Dec",2013-01-01,"ecous",3,"Yr3",3298,0,0,0,0,230,0,0,0,0,3
2010-12-01,"Dec",2013-01-01,"indus",3,"Yr3",7011,250,740,619,1609,846,1,3,3,7,7
2010-12-01,"Dec",2013-01-01,"ustot",3,"Yr3",61610,250,2287,1590,4127,24377,1,7,8,16,201
2011-05-01,"May",2014-01-01,"luxus",3,"Yr3 and later",1032,0,0,2383,2383,6270,0,2,10,12,11
2011-05-01,"May",2014-01-01,"upuus",3,"Yr3 and later",4592,1175,507,2556,4238,8623,1,2,14,17,29
2011-05-01,"May",2014-01-01,"upsus",3,"Yr3 and later",24270,0,11427,22341,33768,17184,0,91,193,284,116
2011-05-01,"May",2014-01-01,"upmus",3,"Yr3 and later",25855,0,9885,10289,20174,7548,0,108,120,228,77
2011-05-01,"May",2014-01-01,"midus",3,"Yr3 and later",5522,0,5081,3185,8266,2266,0,67,58,125,28
2011-05-01,"May",2014-01-01,"ecous",3,"Yr3 and later",4326,66,528,688,1282,498,1,9,29,39,22
2011-05-01,"May",2014-01-01,"indus",3,"Yr3 and later",9546,288,4480,76385,81153,58756,8,42,766,816,433
2011-05-01,"May",2014-01-01,"ustot",3,"Yr3 and later",75143,1529,31908,117827,151264,101145,10,321,1190,1521,716
2011-12-01,"Dec",2014-01-01,"luxus",3,"Yr3",1032,444,0,0,444,845,1,0,0,1,4
2011-12-01,"Dec",2014-01-01,"upuus",3,"Yr3",4592,1175,208,4003,5386,0,1,1,18,20,1
2011-12-01,"Dec",2014-01-01,"upsus",3,"Yr3",24270,168,726,11119,12013,3777,1,4,86,91,28
2011-12-01,"Dec",2014-01-01,"upmus",3,"Yr3",25855,243,0,13533,13776,3432,3,0,139,142,39
2011-12-01,"Dec",2014-01-01,"midus",3,"Yr3",5522,0,0,88,88,577,0,0,1,1,7
2011-12-01,"Dec",2014-01-01,"ecous",3,"Yr3",4326,0,0,157,157,90,0,0,2,2,1
2011-12-01,"Dec",2014-01-01,"indus",3,"Yr3",9546,0,1424,1105,2529,902,0,5,6,11,4
2011-12-01,"Dec",2014-01-01,"ustot",3,"Yr3",75143,2030,2358,30005,34393,9623,6,10,252,268,84
2012-05-01,"May",2015-01-01,"luxus",3,"Yr3 and later",2152,0,2003,2027,4030,5743,0,3,8,11,5
2012-05-01,"May",2015-01-01,"upuus",3,"Yr3 and later",7367,0,949,2261,3210,5998,0,4,10,14,21
2012-05-01,"May",2015-01-01,"upsus",3,"Yr3 and later",31263,361,4701,2953,8015,16630,2,41,23,66,129
2012-05-01,"May",2015-01-01,"upmus",3,"Yr3 and later",31965,147,7246,2260,9653,8450,2,84,26,112,88
2012-05-01,"May",2015-01-01,"midus",3,"Yr3 and later",7679,0,7812,1590,9402,1852,0,104,25,129,24
2012-05-01,"May",2015-01-01,"ecous",3,"Yr3 and later",4290,83,722,593,1398,923,1,10,23,34,30
2012-05-01,"May",2015-01-01,"indus",3,"Yr3 and later",10572,460,7336,60197,67993,44847,8,72,612,692,398
2012-05-01,"May",2015-01-01,"ustot",3,"Yr3 and later",95288,1051,30769,71881,103701,84443,13,318,727,1058,695
2012-12-01,"Dec",2015-01-01,"luxus",3,"Yr3",2152,1412,1036,238,2686,0,2,1,1,4,0
2012-12-01,"Dec",2015-01-01,"upuus",3,"Yr3",7367,500,633,2688,3821,1723,1,3,13,17,6
2012-12-01,"Dec",2015-01-01,"upsus",3,"Yr3",31263,216,1829,7839,9884,4948,1,13,55,69,42
2012-12-01,"Dec",2015-01-01,"upmus",3,"Yr3",31965,113,530,8952,9595,4580,1,6,88,95,46
2012-12-01,"Dec",2015-01-01,"midus",3,"Yr3",7679,0,0,0,0,630,0,0,0,0,8
2012-12-01,"Dec",2015-01-01,"ecous",3,"Yr3",4290,0,0,0,0,200,0,0,0,0,2
2012-12-01,"Dec",2015-01-01,"indus",3,"Yr3",10572,250,3020,557,3827,2106,1,10,4,15,7
2012-12-01,"Dec",2015-01-01,"ustot",3,"Yr3",95288,2491,7048,20274,29813,14187,6,33,161,200,111
2013-05-01,"May",2016-01-01,"luxus",3,"Yr3 and later",NA,0,1311,842,2153,1300,0,3,4,7,5
2013-05-01,"May",2016-01-01,"upuus",3,"Yr3 and later",NA,0,1570,6482,8052,2896,0,7,21,28,11
2013-05-01,"May",2016-01-01,"upsus",3,"Yr3 and later",NA,0,11005,21923,32928,3385,0,88,168,256,25
2013-05-01,"May",2016-01-01,"upmus",3,"Yr3 and later",NA,56,11098,15054,26208,5095,1,117,160,278,48
2013-05-01,"May",2016-01-01,"midus",3,"Yr3 and later",NA,0,2440,1317,3757,1309,0,28,18,46,19
2013-05-01,"May",2016-01-01,"ecous",3,"Yr3 and later",NA,0,837,1454,2291,347,0,12,19,31,23
2013-05-01,"May",2016-01-01,"indus",3,"Yr3 and later",NA,918,14421,56231,71570,49446,2,81,465,548,391
2013-05-01,"May",2016-01-01,"ustot",3,"Yr3 and later",NA,974,42682,103303,146959,63778,3,336,855,1194,522
2013-12-01,"Dec",2016-01-01,"luxus",3,"Yr3",NA,185,1306,0,1491,285,1,2,0,3,1
2013-12-01,"Dec",2016-01-01,"upuus",3,"Yr3",NA,0,3183,360,3543,0,0,11,1,12,0
2013-12-01,"Dec",2016-01-01,"upsus",3,"Yr3",NA,614,7905,9052,17571,2830,4,48,73,125,19
2013-12-01,"Dec",2016-01-01,"upmus",3,"Yr3",NA,177,3039,8302,11518,3577,2,28,82,112,37
2013-12-01,"Dec",2016-01-01,"midus",3,"Yr3",NA,0,0,245,245,1271,0,0,3,3,19
2013-12-01,"Dec",2016-01-01,"ecous",3,"Yr3",NA,0,0,0,0,0,0,0,0,0,0
2013-12-01,"Dec",2016-01-01,"indus",3,"Yr3",NA,0,5135,3158,8293,250,0,7,10,17,1
2013-12-01,"Dec",2016-01-01,"ustot",3,"Yr3",NA,976,20568,21117,42661,8213,7,96,169,272,77
2014-05-01,"May",2017-01-01,"luxus",3,"Yr3 and later",NA,0,200,448,648,0,0,1,2,3,0
2014-05-01,"May",2017-01-01,"upuus",3,"Yr3 and later",NA,196,1752,3094,5042,1500,1,6,13,20,1
2014-05-01,"May",2017-01-01,"upsus",3,"Yr3 and later",NA,305,274,6281,6860,0,2,3,48,53,0
2014-05-01,"May",2017-01-01,"upmus",3,"Yr3 and later",NA,0,0,4348,4348,0,0,0,43,43,0
2014-05-01,"May",2017-01-01,"midus",3,"Yr3 and later",NA,0,144,2278,2422,0,0,2,31,33,0
2014-05-01,"May",2017-01-01,"ecous",3,"Yr3 and later",NA,0,0,80,80,0,0,0,1,1,0
2014-05-01,"May",2017-01-01,"indus",3,"Yr3 and later",NA,900,1830,1100,3830,2373,1,3,3,7,7
2014-05-01,"May",2017-01-01,"ustot",3,"Yr3 and later",NA,1401,4200,17629,23230,3873,4,15,141,160,8
2014-12-01,"Dec",2017-01-01,"luxus",3,"Yr3",NA,2192,264,1417,3873,0,3,1,4,8,0
2014-12-01,"Dec",2017-01-01,"upuus",3,"Yr3",NA,496,3811,4413,8720,1707,2,12,13,27,2
2014-12-01,"Dec",2017-01-01,"upsus",3,"Yr3",NA,185,3183,15291,18659,205,3,24,120,147,1
2014-12-01,"Dec",2017-01-01,"upmus",3,"Yr3",NA,0,1797,16526,18323,0,0,19,161,180,0
2014-12-01,"Dec",2017-01-01,"midus",3,"Yr3",NA,0,80,3995,4075,0,0,1,54,55,0
2014-12-01,"Dec",2017-01-01,"ecous",3,"Yr3",NA,0,0,67,67,0,0,0,2,2,0
2014-12-01,"Dec",2017-01-01,"indus",3,"Yr3",NA,0,3075,1837,4912,835,0,7,6,13,6
2014-12-01,"Dec",2017-01-01,"ustot",3,"Yr3",NA,2873,12210,43546,58629,2747,8,64,360,432,9
2015-05-01,"May",2018-01-01,"luxus",3,"Yr3 and later",NA,728,369,170,1267,0,3,1,1,5,0
2015-05-01,"May",2018-01-01,"upuus",3,"Yr3 and later",NA,0,1464,2510,3974,0,0,6,10,16,0
2015-05-01,"May",2018-01-01,"upsus",3,"Yr3 and later",NA,1133,1128,5499,7760,0,6,6,39,51,0
2015-05-01,"May",2018-01-01,"upmus",3,"Yr3 and later",NA,0,397,5677,6074,0,0,3,55,58,0
2015-05-01,"May",2018-01-01,"midus",3,"Yr3 and later",NA,0,135,600,735,0,0,1,8,9,0
2015-05-01,"May",2018-01-01,"ecous",3,"Yr3 and later",NA,0,0,80,80,0,0,0,1,1,0
2015-05-01,"May",2018-01-01,"indus",3,"Yr3 and later",NA,3683,400,1066,5149,0,3,3,8,14,0
2015-05-01,"May",2018-01-01,"ustot",3,"Yr3 and later",NA,5544,3893,15602,25039,0,12,20,122,154,0
2015-12-01,"Dec",2018-01-01,"luxus",3,"Yr3",NA,727,1132,1227,3086,0,3,4,5,12,0
2015-12-01,"Dec",2018-01-01,"upuus",3,"Yr3",NA,288,4143,5430,9861,0,1,23,17,41,0
2015-12-01,"Dec",2018-01-01,"upsus",3,"Yr3",NA,1019,10551,7640,19210,0,5,81,62,148,0
2015-12-01,"Dec",2018-01-01,"upmus",3,"Yr3",NA,175,9345,11349,20869,0,2,91,110,203,0
2015-12-01,"Dec",2018-01-01,"midus",3,"Yr3",NA,0,0,2692,2692,0,0,0,30,30,0
2015-12-01,"Dec",2018-01-01,"ecous",3,"Yr3",NA,0,85,263,348,0,0,1,1,2,0
2015-12-01,"Dec",2018-01-01,"indus",3,"Yr3",NA,4289,1992,3107,9388,0,5,6,16,27,0
2015-12-01,"Dec",2018-01-01,"ustot",3,"Yr3",NA,6498,27248,31708,65454,0,16,206,241,463,0
2016-05-01,"May",2019-01-01,"luxus",3,"Yr3 and later",NA,435,650,300,1385,0,2,3,2,7,0
2016-05-01,"May",2019-01-01,"upuus",3,"Yr3 and later",NA,612,1228,2200,4040,0,3,6,11,20,0
2016-05-01,"May",2019-01-01,"upsus",3,"Yr3 and later",NA,1226,2053,3512,6791,0,10,15,26,51,0
2016-05-01,"May",2019-01-01,"upmus",3,"Yr3 and later",NA,689,382,4397,5468,0,7,3,43,53,0
2016-05-01,"May",2019-01-01,"midus",3,"Yr3 and later",NA,0,0,3099,3099,0,0,0,45,45,0
2016-05-01,"May",2019-01-01,"ecous",3,"Yr3 and later",NA,0,0,80,80,0,0,0,1,1,0
2016-05-01,"May",2019-01-01,"indus",3,"Yr3 and later",NA,0,180,4742,4922,0,0,2,8,10,0
2016-05-01,"May",2019-01-01,"ustot",3,"Yr3 and later",NA,2962,4493,18330,25785,0,22,29,136,187,0
2007-12-01,"Dec",2011-01-01,"luxus",4,"Yr4 and later",1807,0,0,2940,2940,1544,0,0,10,10,7
2007-12-01,"Dec",2011-01-01,"upuus",4,"Yr4 and later",6002,0,1415,7360,8775,8428,1,3,34,38,14
2007-12-01,"Dec",2011-01-01,"upsus",4,"Yr4 and later",8955,0,783,7473,8256,7077,0,10,84,94,43
2007-12-01,"Dec",2011-01-01,"midwus",4,"Yr4 and later",NA,0,538,1447,1985,998,2,7,28,37,7
2007-12-01,"Dec",2011-01-01,"midwous",4,"Yr4 and later",NA,0,617,5993,6610,1149,1,15,176,192,21
2007-12-01,"Dec",2011-01-01,"ecous",4,"Yr4 and later",1745,0,922,2299,3221,344,0,73,87,160,6
2007-12-01,"Dec",2011-01-01,"indus",4,"Yr4 and later",3634,42,3015,134182,137239,61507,4,32,1343,1379,340
2007-12-01,"Dec",2011-01-01,"ustot",4,"Yr4 and later",42107,42,7290,161694,169026,81047,8,140,1762,1910,438
2008-12-01,"Dec",2012-01-01,"luxus",4,"Yr4 and later",208,0,0,1211,1211,1067,0,0,8,8,8
2008-12-01,"Dec",2012-01-01,"upuus",4,"Yr4 and later",2548,0,830,6368,7198,5880,0,2,29,31,19
2008-12-01,"Dec",2012-01-01,"upsus",4,"Yr4 and later",10050,287,921,8482,9690,3854,2,8,102,112,29
2008-12-01,"Dec",2012-01-01,"midwus",4,"Yr4 and later",NA,0,543,2092,2635,1697,1,6,37,44,15
2008-12-01,"Dec",2012-01-01,"midwous",4,"Yr4 and later",NA,185,1789,8267,10241,4929,2,32,156,190,77
2008-12-01,"Dec",2012-01-01,"ecous",4,"Yr4 and later",2731,0,4527,3029,7556,709,0,57,69,126,12
2008-12-01,"Dec",2012-01-01,"indus",4,"Yr4 and later",7084,100,2372,120822,123294,72213,7,33,1229,1269,453
2008-12-01,"Dec",2012-01-01,"ustot",4,"Yr4 and later",42593,572,10982,150271,161825,90349,12,138,1630,1780,613
2009-12-01,"Dec",2013-01-01,"luxus",4,"Yr4 and later",693,0,0,627,627,1512,0,1,3,4,9
2009-12-01,"Dec",2013-01-01,"upuus",4,"Yr4 and later",4458,460,1619,3216,5295,11724,2,3,19,24,32
2009-12-01,"Dec",2013-01-01,"upsus",4,"Yr4 and later",18571,0,2834,9656,12490,10259,0,23,93,116,82
2009-12-01,"Dec",2013-01-01,"midwus",4,"Yr4 and later",NA,170,830,1812,2812,1020,3,12,32,47,9
2009-12-01,"Dec",2013-01-01,"midwous",4,"Yr4 and later",NA,72,2681,9528,12281,3554,1,40,147,188,51
2009-12-01,"Dec",2013-01-01,"ecous",4,"Yr4 and later",3298,0,767,3183,3950,719,0,14,51,65,15
2009-12-01,"Dec",2013-01-01,"indus",4,"Yr4 and later",7011,874,2471,99272,102617,62578,18,27,953,998,431
2009-12-01,"Dec",2013-01-01,"ustot",4,"Yr4 and later",61610,1576,11202,127294,140072,91366,24,120,1298,1442,629
2010-12-01,"Dec",2014-01-01,"luxus",4,"Yr4 and later",1032,0,400,1976,2376,1370,0,3,9,12,7
2010-12-01,"Dec",2014-01-01,"upuus",4,"Yr4 and later",4592,1175,0,2911,4086,11882,1,1,19,21,27
2010-12-01,"Dec",2014-01-01,"upsus",4,"Yr4 and later",24270,109,6746,23598,30453,13517,2,56,192,250,98
2010-12-01,"Dec",2014-01-01,"midwus",4,"Yr4 and later",NA,182,594,714,1490,663,3,8,15,26,6
2010-12-01,"Dec",2014-01-01,"midwous",4,"Yr4 and later",NA,92,4596,13091,17779,5588,1,58,167,226,60
2010-12-01,"Dec",2014-01-01,"ecous",4,"Yr4 and later",4326,0,212,834,1046,293,1,7,31,39,24
2010-12-01,"Dec",2014-01-01,"indus",4,"Yr4 and later",9546,203,4190,80893,85286,56275,6,43,806,855,407
2010-12-01,"Dec",2014-01-01,"ustot",4,"Yr4 and later",75143,1761,16738,124017,142516,89588,14,176,1239,1429,629
2011-12-01,"Dec",2015-01-01,"luxus",4,"Yr4 and later",2152,0,1044,1683,2727,5595,0,3,9,12,8
2011-12-01,"Dec",2015-01-01,"upuus",4,"Yr4 and later",7367,0,0,4365,4365,4237,0,0,16,16,19
2011-12-01,"Dec",2015-01-01,"upsus",4,"Yr4 and later",31263,321,3295,4718,8334,13439,2,29,47,78,98
2011-12-01,"Dec",2015-01-01,"upmus",4,"Yr4 and later",31965,594,8167,6791,15552,7806,7,95,80,182,89
2011-12-01,"Dec",2015-01-01,"midus",4,"Yr4 and later",7679,351,5797,745,6893,3024,7,77,13,97,40
2011-12-01,"Dec",2015-01-01,"ecous",4,"Yr4 and later",4290,0,448,1032,1480,724,0,7,24,31,29
2011-12-01,"Dec",2015-01-01,"indus",4,"Yr4 and later",10572,291,7688,64451,72430,51869,15,55,659,729,437
2011-12-01,"Dec",2015-01-01,"ustot",4,"Yr4 and later",95288,1557,26439,83785,111781,86694,31,266,848,1145,720
2012-12-01,"Dec",2016-01-01,"luxus",4,"Yr4 and later",NA,0,0,1335,1335,790,0,1,7,8,3
2012-12-01,"Dec",2016-01-01,"upuus",4,"Yr4 and later",NA,0,302,2156,2458,4026,0,2,7,9,15
2012-12-01,"Dec",2016-01-01,"upsus",4,"Yr4 and later",NA,0,6460,6609,13069,8756,0,53,54,107,59
2012-12-01,"Dec",2016-01-01,"upmus",4,"Yr4 and later",NA,56,4628,4976,9660,4944,1,52,56,109,50
2012-12-01,"Dec",2016-01-01,"midus",4,"Yr4 and later",NA,0,4621,1363,5984,1744,0,59,19,78,21
2012-12-01,"Dec",2016-01-01,"ecous",4,"Yr4 and later",NA,0,545,958,1503,373,0,7,14,21,24
2012-12-01,"Dec",2016-01-01,"indus",4,"Yr4 and later",NA,118,7083,59837,67038,54268,3,68,479,550,395
2012-12-01,"Dec",2016-01-01,"ustot",4,"Yr4 and later",NA,174,23639,77234,101047,74901,4,242,636,882,567
2013-12-01,"Dec",2017-01-01,"luxus",4,"Yr4 and later",NA,0,300,0,300,278,0,1,0,1,1
2013-12-01,"Dec",2017-01-01,"upuus",4,"Yr4 and later",NA,0,450,3176,3626,0,0,1,8,9,0
2013-12-01,"Dec",2017-01-01,"upsus",4,"Yr4 and later",NA,125,196,2108,2429,123,1,1,14,16,1
2013-12-01,"Dec",2017-01-01,"upmus",4,"Yr4 and later",NA,0,0,395,395,865,0,0,3,3,9
2013-12-01,"Dec",2017-01-01,"midus",4,"Yr4 and later",NA,0,0,0,0,224,0,0,0,0,3
2013-12-01,"Dec",2017-01-01,"ecous",4,"Yr4 and later",NA,0,0,0,0,0,0,0,0,0,0
2013-12-01,"Dec",2017-01-01,"indus",4,"Yr4 and later",NA,900,2050,400,3350,400,1,3,1,5,1
2013-12-01,"Dec",2017-01-01,"ustot",4,"Yr4 and later",NA,1025,2996,6079,10100,1890,2,6,26,34,15
2014-12-01,"Dec",2018-01-01,"luxus",4,"Yr4 and later",NA,0,369,573,942,0,0,1,2,3,0
2014-12-01,"Dec",2018-01-01,"upuus",4,"Yr4 and later",NA,0,250,1399,1649,0,0,1,6,7,0
2014-12-01,"Dec",2018-01-01,"upsus",4,"Yr4 and later",NA,243,0,4129,4372,0,2,0,26,28,0
2014-12-01,"Dec",2018-01-01,"upmus",4,"Yr4 and later",NA,53,0,2486,2539,0,1,0,25,26,0
2014-12-01,"Dec",2018-01-01,"midus",4,"Yr4 and later",NA,0,0,300,300,0,0,0,5,5,0
2014-12-01,"Dec",2018-01-01,"ecous",4,"Yr4 and later",NA,0,0,80,80,0,0,0,1,1,0
2014-12-01,"Dec",2018-01-01,"indus",4,"Yr4 and later",NA,0,0,830,830,1500,0,2,4,6,3
2014-12-01,"Dec",2018-01-01,"ustot",4,"Yr4 and later",NA,296,619,9797,10712,1500,3,4,69,76,3
2015-12-01,"Dec",2019-01-01,"luxus",4,"Yr4 and later",NA,148,0,300,448,0,1,0,1,2,0
2015-12-01,"Dec",2019-01-01,"upuus",4,"Yr4 and later",NA,0,462,1100,1562,0,0,1,5,6,0
2015-12-01,"Dec",2019-01-01,"upsus",4,"Yr4 and later",NA,0,0,2671,2671,0,0,0,18,18,0
2015-12-01,"Dec",2019-01-01,"upmus",4,"Yr4 and later",NA,0,64,2647,2711,0,0,1,25,26,0
2015-12-01,"Dec",2019-01-01,"midus",4,"Yr4 and later",NA,0,0,240,240,0,0,0,5,5,0
2015-12-01,"Dec",2019-01-01,"ecous",4,"Yr4 and later",NA,0,0,80,80,0,0,0,1,1,0
2015-12-01,"Dec",2019-01-01,"indus",4,"Yr4 and later",NA,0,180,364,544,0,0,2,4,6,0
2015-12-01,"Dec",2019-01-01,"ustot",4,"Yr4 and later",NA,148,706,7402,8256,0,1,4,59,64,0
